Whiskas/Mono joined in Norway as musician.
Mic^Flair sold AMiga and left the Scene.

g.d.m.      - graphician, musician, sysop, ascii & world organizer  [russia]
arcane      - sysop                                                 [norway]
dmd!        - graphician & ascii                                    [russia]
dee'mon     - musician & raytracer                                  [russia]
dyer        - graphician                                            [russia]
inco        - musician                                              [sweden]
javis       - ascii                                                 [germany]
joker (rj)  - musician, coder                                       [russia]
juggler     - coder                                                 [russia]
kimba       - graphician                                            [australia]
lunasoul    - graphician                                            [russia]
mogue       - sysop                                                 [germany]
notorious   - editor & swapper                                      [russia]
shin        - coder                                                 [russia]
speed devil - swapper & ascii                                       [norway]
tangerine   - musician                                              [russia]
tommy       - musician                                              [sweden]
vouck       - ascii                                                 [germany]
xpeh        - musician & sysop                                      [russia]
whiskas     - musician                                              [norway]
zinko       - sysop & dk organizer                                  [denmark]
zanok       - sysop                                                 [sweden]
zoltrix     - sysop                                                 [u.k.  ]

Purple dream        - LKR WHQ - STATIC TELNET IP - 194.190.214.83 -
Neon dream          - LKR RHQ
The northern palace - LKR EURO HQ - TELNET - /WHOIS ZINKO
Spaced out          - LKR UKHQ    - TELNET - /WHOIS ZOLTRIX
Straight Hate       - LKR GHQ     - TELNET - /WHOIS MOGUE


